{
    "level1": [
        ["c", ".", ".", "x", ".", ".", ".", "k", ".", ".", "L", ".", ".", "f"],
        [".", "x", ".", ".", ".", "x", ".", "x", ".", "x", "x", "x", "x", "x"],
        [".", ".", ".", "x", ".", ".", ".", ".", ".", ".", ".", ".", ".", "."],
        ["x", ".", ".", ".", ".", "x", ".", "x", ".", "x", ".", ".", "x", "."],
        [".", "x", ".", "x", ".", ".", ".", ".", ".", ".", ".", ".", ".", "."]
    ],
    "level2": [
        ["c", ".", ".", ".", ".", ".", ".", ".", ".", "x", ".", ".", ".", "."],
        [".", "x", "x", ".", "x", ".", "x", "x", ".", ".", ".", "x", "x", "."],
        [".", ".", ".", ".", ".", ".", ".", ".", ".", "x", ".", ".", ".", "."],
        ["x", "x", ".", "x", ".", "x", ".", "x", ".", ".", ".", "x", ".", "."],
        [".", ".", ".", ".", ".", ".", ".", ".", ".", "x", ".", ".", ".", "."],
        [".", "x", "x", ".", "x", ".", "x", ".", ".", ".", ".", "x", "x", "x"],
        ["K", ".", ".", ".", ".", ".", ".", ".", ".", "x", ".", "B", ".", "f"]
    ],
    "level3": [
        ["c", ".", ".", ".", "b", ".", ".", "p", "x", ".", ".", "L", "D", "f"],
        [".", "x", "x", ".", ".", ".", "x", "x", "x", ".", "x", "x", "x", "x"],
        [".", ".", ".", ".", ".", ".", ".", ".", ".", ".", ".", ".", ".", "."],
        ["x", ".", "x", ".", "x", ".", "x", ".", "x", ".", "x", ".", "x", "."],
        [".", ".", ".", ".", ".", ".", ".", ".", ".", ".", ".", ".", ".", "."],
        [".", "x", ".", "x", ".", "x", ".", "x", ".", "x", ".", "x", ".", "."],
        ["k", ".", ".", ".", ".", ".", ".", ".", ".", ".", ".", ".", ".", "."]
    ],
    "level4": [
        ["c", ".", ".", ".", "K", ".", ".", ".", ".", ".", ".", "x", ".", "."],
        [".", "x", "x", "x", "x", "x", ".", "x", "x", "x", "x", "x", ".", "."],
        [".", ".", ".", ".", ".", ".", ".", ".", ".", ".", ".", "x", ".", "."],
        ["x", "x", ".", "x", ".", "x", "x", "x", ".", "x", ".", "x", "x", "."],
        [".", ".", ".", ".", "b", ".", ".", ".", "p", ".", ".", "D", ".", "."],
        [".", "x", "x", ".", "x", ".", "x", ".", "x", ".", "x", "x", "x", "B"],
        [".", ".", ".", ".", ".", ".", "x", ".", ".", ".", ".", ".", "x", "f"]
    ],
    "level5": [
        ["c", "x", ".", "b", ".", ".", "p", "x", "x", "x", "x", "x", ".", "."],
        [".", "x", "K", "x", ".", ".", "x", ".", ".", ".", ".", "x", ".", "."],
        [".", "x", ".", "x", ".", ".", "x", ".", "x", "x", ".", "x", ".", "."],
        [".", "x", ".", "x", ".", ".", "x", ".", "x", "x", ".", "x", "x", "x"],
        [".", ".", ".", "x", ".", ".", "D", ".", "x", "x", ".", "B", ".", "f"]
    ]
}